быть	be [bi:] was [wɔz], were [wз:] been [bi:n]
Бить	beat [bi:t] beat [bi:t] beaten ['bi:tn]
Становиться	become [bi:kʌm] became [bi:keim] become[bi:kʌm]
Начинать	begin [bi'gin] began [bi'gæn] begun [bi'gʌn]
Кровоточить	bleed [bli:d] bled [bled] bled [bled]
Дуть	blow [blou] blew [blu:] blown [bloun]
Ломать	break [breik] broke [brouk] broken ['brouk(e)n]
Приносить	bring [briŋ] brought [brɔ:t] brought [brɔ:t]
Строить	build [bild] built [bilt] built [bilt]
Гореть	burn [bз:n] burnt [bз:nt] burnt [bз:nt]
Разразиться	burst [bз:st] burst [bз:st] burst [bз:st]
Покупать	buy [bai] bought [bɔ:t] bought [bɔ:t]
Ловить, хватать, успеть	catch [kætʃ] caught [kɔ:t] caught [kɔ:t]
Выбирать	choose [tʃu:z] chose [ʃəuz] chosen [tʃəuz(ə)n]
Приходить	come [kʌm] came [keim] come [kʌm]
Стоить	cost [cɔst] cost [cɔst] cost [cɔst]
Ползать	creep [kri:p] crept [krept] crept [krept]
Резать	cut [kʌt] cut [kʌt] cut [kʌt]
Делать	do [du:] did [did] done [dʌn]
Рисовать, тащить	draw [drɔ:] drew [dru:] drawn [drɔ:n]
Мечтать, дремать	dream [dri:m] dreamt [dremt] dreamt [dremt]
Пить	drink [driŋk] drank [dræŋk] drunk [drʌŋk]
Водить	drive [draiv] drove [drouv] driven ['drivn]
Есть	eat [i:t] ate [et] eaten ['i:tn]
Падать	fall [fɔ:l] fell [fel] fallen ['fɔ:lən]
Кормить	feed [fi:d] fed [fed] fed [fed]
Чувствовать	feel [fi:l] felt [felt] felt [felt]
Бороться	fight [fait] fought [fɔ:t] fought [fɔ:t]
Находить	find [faind] found [faund] found [faund]
Подходить по размеру	fit [fit] fit [fit] fit [fit]
Летать	fly [flai] flew [flu:] flown [floun]
Забывать	forget [fə'get] forgot [fə'gɔt] forgotten [fə'gɔt(ə)n]
Прощать	forgive [fo'giv] forgave [fo'geiv] forgiven [fo'givn]
Замерзать	freeze [fri:z] froze [frouz] frozen ['frouzn]
Получать	get [ get ] got [gɔt] got [gɔt]
Давать	give [giv] gave [geiv] given [givn]
Идти	go [gou] went [went] gone [gɔn]
Расти	grow [grou] grew [gru:] grown [groun]
Вешать	hang [hæŋ] hung [hʌŋ] hung [hʌŋ]
Иметь	have [hæv] had [hæd] had [hæd]
Слышать	hear [hiə] heard [hз:d] heard [hз:d]
Прятать	hide [haid] hid [hid] hidden ['hidn]
Попадать в цель	hit [hit] hit [hit] hit [hit]
Держать	hold [hould] held [held] held [held]
Ушибить	hurt [hз:t] hurt [hз:t] hurt [hз:t]
Содержать	keep [ki:p] kept [kept] kept [kept]
Стоять на коленях	kneel [ni:l] knelt [nelt] knelt [nelt]
Знать	know [nou] knew [nju:] known [noun]
Класть	lay [lei] laid [leid] laid [leid]
Вести	lead [li:d] led [led] led [led]
Наклоняться	lean [li:n] leant [lent] leant [lent]
Учить	learn [lз:n] learnt [lз:nt] learnt [lз:nt]
Оставлять	leave [li:v] left [left] left [left]
Занимать	lend [lend] lent [lent] lent [lent]
Позволять	let [let] let [let] let [let]
Лежать	lie [lai] lay [lei] lain [lein]
Освещать	light [lait] lit [lit] lit [lit]
Терять	lose [lu:z] lost [lɔst] lost [lɔst]
Производить	make [meik] made [meid] made [meid]
Значить	mean [mi:n] meant [ment] meant [ment]
Встречать	meet [mi:t] met [met] met [met]
Ошибаться	mistake [mis'teik] mistook [mis'tuk] mistaken [mis'teik(e)n]
Платить	pay [pei] paid [peid] paid [peid]
Доказывать	prove [pru:v] proved [pru:vd] proven [pru:vn]
Положить	put [put] put [put] put [put]
Выходить	quit [kwit] quit [kwit] quit [kwit]
Читать	read [ri:d] read [red] read [red]
Ездить верхом	ride [raid] rode [roud] ridden ['ridn]
Звенеть	ring [riŋ] rang [ræŋ] rung [rʌŋ]
Подниматься	rise [raiz] rose [rouz] risen ['rizn]
Бежать	run [rʌŋ] ran [ræŋ] run [rʌŋ]
Сказать	say [sei] said [sed] said [sed]
Видеть	see [si:] saw [sɔ:] seen [si:n]
Искать	seek [si:k] sought [sɔ:t] sought [sɔ:t]
Продавать	sell [sel] sold [sould] sold [sould]
Посылать	send [send] sent [sent] sent [sent]
Ставить	set [set] set [set] set [set]
Шить	sew [sou] sewed [soud] sewn [soun]
Встряхивать	shake [ʃeik] shook [ʃuk] shaken ['ʃeik(ə)n]
Показывать	show [ʃəu] showed [ʃəud] shown [ʃəun]
Уменьшать	shrink [ʃriŋk] shrank [ʃræŋk] shrunk [ʃrʌŋk]
Закрывать	shut [ʃʌt] shut [ʃʌt] shut [ʃʌt]
Петь	sing [siŋ] sang [sæŋ] sung [sʌŋ]
Тонуть	sink [siŋk] sank [sæŋk], sunk [sʌŋk]
Сидеть	sit [sit] sat [sæt] sat [sæt]
Спать	sleep [sli:p] slept [slept] slept [slept]
Скользить	slide [slaid] slid [slid] slid [slid]
Сеять	sow [sou] sowed [soud] sown [soun]
Говорить	speak [spi:k] spoke [spouk] spoken ['spouk(e)n]
Произносить по буквам	spell [spel] spelt [spelt] spelt [spelt]
Тратить	spend [spend] spent [spent] spent [spent]
Проливать	spill [spil] spilt [spilt] spilt [spilt]
Портить	spoil [spɔil] spoilt [spɔilt] spoilt [spɔilt]
Расстилать	spread [spred] spread [spred] spread [spred]
Прыгать	spring [spriŋ] sprang [spræŋ] sprung [sprʌŋ]
Стоять	stand [stænd] stood [stu:d] stood [stu:d]
Красть	steal [sti:l] stole [stoul] stolen ['stəulən]
Колоть	stick [stik] stuck [stʌk] stuck [stʌk]
Жалить	sting [stiŋ] stung [stʌŋ] stung [stʌŋ]
Выметать	sweep [swi:p] swept [swept] swept [swept]
Разбухать	swell [swel] swelled [sweld] swollen ['swoul(e)n]
Плавать	swim [swim] swam [swem] swum [swʌm]
Качать	swing [swiŋ] swung [swʌŋ] swung [swʌŋ]
Брать, взять	take [teik] took [tuk] taken ['teik(ə)n]
Учить, преподавать	teach [ti:tʃ] taught [tɔ:t] taught [tɔ:t]
Рвать	tear [tɛə] tore [tɔ:] torn [tɔ:n]
Рассказывать	tell [tel] told [tould] told [tould]
Думать	think [θiŋk] thought [θɔ:t] thought [θɔ:t]
Бросать	throw [θrəu] threw [θru:] thrown [θrəun]
Понимать	understand [ʌndə'stænd] understood [ʌndə'stud] understood [ʌndə'stud]
Просыпаться	wake [weik] woke [wouk] woken ['wouk(e)n]
Носить	wear [wɛə] wore [wɔ:] worn [wɔ:n]
Плакать	weep [wi:p] wept [wept] wept [wept]
Мочить	wet [wet] wet [wet] wet [wet]
Выигрывать	win [win] won [wʌn] won [wʌn]
Извиваться	wind [waind] wound [waund] wound [waund]
Писать	write [rait] wrote [rout] written ['ritn]